ALL	AO L
ESS	EH S
FORECAST	F AO R K AE S T
GO	G OW
HEADLINES	HH EH D L AY N Z
LISTENING	L IH S AH N IH NG
LISTENING(2)	L IH S N IH NG
ME	M IY
MIND	M AY N D
NEVER	N EH V ER
NEWS	N UW Z
NEWS(2)	N Y UW Z
READ	R EH D
READ(2)	R IY D
REPORT	R IY P AO R T
REPORT(2)	R IH P AO R T
SCIENCE	S AY AH N S
SLEEP	S L IY P
STOP	S T AA P
TO	T UW
TO(2)	T IH
TO(3)	T AH
WEATHER	W EH DH ER
WORLD	W ER L D
YOU	Y UW
